11111111111111111111111111111
10000000000000000111001000001
10000000000000100110000000001
10000E00000000000000000000001
10000001110001110100000000001
1000000000000000000C0000000X1
100001111100000010000C0000001
10000000000000000000000010011
10000001110001110100000000001
1000P00E00C00000C00000C000C01
11111111111111111111111111111