11111111111111111111111111111
10000000000000000111001000001
100000000000001001100000P0001
10000E0000CC00000000CCC000001
1000C001110001110100000000001
10000000000000000000C00000001
100001111000C0000000000C00001
10000000000000000000000010011
1000001C1110001101000C0000001
10000000000000000C00000000001
11111111111111111111111111111